%%%%%%%%%%%%%%%%%%%%%%%%%%%%%%%%%%%%%%%%%
%                                       %
%                                       %
%                        %              %
%                        %              %
%             %          %              %
%   P         %                    .    %
%             %          %              %
%                        %              %
%                        %              %
%                                       %
%                                       %
%                                       %
%%%%%%%%%%%%%%%%%%%%%%%%%%%%%%%%%%%%%%%%%
