%%%%%%%%%%%%%%%%%%%%%%%%%%%%%%%%%%%%%%%%%
%                                       %
%                                       %
%                        %              %
%          %%%%          %              %
%          %  %          %              %
%             %          %         .    %
%             %          %              %
%   P         %          %              %
%                        %              %
%                                       %
%                                       %
%                                       %
%%%%%%%%%%%%%%%%%%%%%%%%%%%%%%%%%%%%%%%%%
