%%%%%%%%%%%%%%%%%%%%%%%%%%%%%%%%%%%%%%%%%
%                                       %
%                                       %
%                        %              %
%          %%%%          %              %
%          %  %          %              %
%   P         %          %         .    %
%             %          %              %
%             %          %              %
%                        %              %
%                                       %
%                                       %
%                                       %
%%%%%%%%%%%%%%%%%%%%%%%%%%%%%%%%%%%%%%%%%
