%%%%%%%%%%%%%%%%%%%%%%%%%%%%%%%%%%%%%%%%%
%                                       %
%                                       %
%                        %              %
%          %%%%          %%%%%%%%%%%%   %
%          %  %          %              %
%   P         %          %         .    %
%             %          %              %
%             %          %%%%%%%%%%%%   %
%                        %              %
%                                       %
%                                       %
%                                       %
%%%%%%%%%%%%%%%%%%%%%%%%%%%%%%%%%%%%%%%%%
